################################################## 
################################################## 
#########                                ######### 
#######                                    ####### 
#####                                        ##### 
###                                            ### 
|                                                | 
###                                            ### 
#####                                        ##### 
#######                                    ####### 
#########                                ######### 
################################################## 
################################################## 
