===================================^^^^^^^^^^^^^^^
===============================^^^^^^^^^^^^^^^^^^^
===========================^^^^^^^^^^^^^^^^^^^^^^^
=====================^^^^^^^^^^^^^^^^^^^^^^^^^^^^^
=======================^^^^^^^^^^^^^^^^^^^^^^^^^^^
====================^^^^^^^^^^^^^^^^^^^^^^^^^^^^^^
==================================|^^^^^^^^^^^^^^^
================^^^^^^^^^^^^^^^^^^^^^^^^^^^^^^^^^^
==============^^^^^^^^^^^^^^^^^^^^^^^^^^^^^^^^^^^^
==========^^^^^^^^^^^^^^^^^^^^^^^^^^^^^^^^^^^^^^^^
====^^^^^^^^^^^^^^^^^^^^^^^^^^^^^^^^^^^^^^^^^^^^^^
^^^^^^^^^^^^^^^^^^^^^^^^^^^^^^^^^^^^^^^^^^^^^^^^^^
