========================================================
====............................========================
======..............................====================
============..............................==============
==================.....................................|
===============================........................=
========================================================
========================================================
