^^^^^^^^^^^^^^^^^^^^^^^^&&&&&^^^^^^^^^^^^^^^^^^^^^^^^^^^^^^^^^^^
^^^^^^^^^^^^^^^^^^^^^^^^^^&&&&&^^^^^^^^^^^^^^^^^^^^^^^^^^^^^^^^^
^^^^^^^^^^^^^^^^^^^^^^^^^^^&&&&&&^^^^^^^^^^^^^^^^^^^^^^^^^^^^^^^
^^^^^^^^^^^^^^^^^^^^^^^^^^^^^&&&&&^^^^^^^^..........^^^^^^^^^^^^
^^^^^^^^^^^^^^^^^^^^^^^^^^^^&&&............^^^^^^^^............%
^^^^^^^^^^^^^^^^^^^^^^^^^^^^....&&&^^^^^^^^^^^^^^^^^^^^^^^^^^^^^
.......^^^^^^^^^^^^^^........^^^&&&&&&^^^^^^^^^^^^^^^^^^^^^^^^^^
^^^^^^................^^^^^^^^^^^^^&&&&^^^^^^^^^^^^^^^^^^^^^^^^^
^^^^^^^^^^^^^^^^^^^^^^^^^^^^^^^^^^^^^&&&&^^^^^^^^^^^^^^^^^^^^^^^
^^^^^^^^^^^^^^^^^^^^^^^^^^^^^^^^^^^^^^^&&&&^^^^^^^^^^^^^^^^^^^^^
^^^^^^^^^^^^^^^^^^^^^^^^^^^^^^^^^^^^^&&&&^^^^^^^^^^^^^^^^^^^^^^^
^^^^^^^^^^^^^^^^^^^^^^^^^^^^^^^^^^^^^^^&&&&&^^^^^^^^^^^^^^^^^^^^
