""""""""""""""""""""""""""""""""""""""""--------------
"""""""""""""""""""""""""""""-------------------------
""""""""""""""""""""""""""----------------------------
""""""""""""""""""""""""""""""------------------------
"""""""""""""""""""""""-------------------------------
""""""""""""""""""""""""-----------------------------|
""""""""""""""""""""----------------------------------
""""""""""""""""--------------------------------------
"""""""""""""""""-------------------------------------
""""""""""""""----------------------------------------
""""""""""""------------------------------------------
