--------------------------------------~~~~~~~~~~~~~~~~~~~~
--------------------------------~~~~~~~~~~~~~~~~~~~~~~~~~~
--------------------------~~~~~~~~~~~~~~~~~~~~~~~~~~~~~~~~
----------------------~~~~~~~~~~~~~~.....................|
--------------......................................~~~~~~
------..............................~~~~~~~~~~~~~~~~~~~~~~
..............-~~~~~~~~~~~~~~~~~~~~~~~~~~~~~~~~~~~~~~~~~~~
.......----~~~~~~~~~~~~~~~~~~~~~~~~~~~~~~~~~~~~~~~~~~~~~~~
----~~~~~~~~~~~~~~~~~~~~~~~~~~~~~~~~~~~~~~~~~~~~~~~~~~~~~~
------~~~~~~~~~~~~~~~~~~~~~~~~~~~~~~~~~~~~~~~~~~~~~~~~~~~~
~~~~~~~~~~~~~~~~~~~~~~~~~~~~~~~~~~~~~~~~~~~~~~~~~~~~~~~~~~
