)))))))))))))))))))))))))))))))))===================
)))))))))))))))))))))))))))))))=====================
))))))))))))))))))))))))))==========================
)))))))))))))))))))))))=============================
)))))))))))))))))))))))))))=========================
))))))))))))))))))))================================
)))))))))))))))))))))))))))))))))===================
)))))))))))))))))))))===============================
))))))))))))))======================================
))))))))))))))))))))))))============================
)))))))))))))))))===================================
))))))))============================================
