$$$$$$$$$$$$$$$$$$$ $$$$$$$$$$$$$$$$$$$
$$$$$$$$$$$$$$$$$$   $$$$$$$$$$$$$$$$$$
$$$$$$$$$$$$$$$$       $$$$$$$$$$$$$$$$
$$$$$$$$$$$$$$           $$$$$$$$$$$$$$
$$$$$$$$$$$$$      0      $$$$$$$$$$$$$
$$$$$$$$$$$$$$           $$$$$$$$$$$$$$
$$$$$$$$$$$$$$$$       $$$$$$$$$$$$$$$$
$$$$$$$$$$$$$$$$$$   $$$$$$$$$$$$$$$$$$
$$$$$$$$$$$$$$$$$$$ $$$$$$$$$$$$$$$$$$$
